**********
*        *
*        *
*        *
*        *
*        *
*        *
*        *
*       G*
**********
