**********
*p       *
*        *
*        *
*        *
*        *
*        *
*        *
*       G*
**********
